NO ./wall_no.xpm
SO ./wall_so.xpm
WE ./wall_we.xpm
EA ./wall_ea.xpm
F 0,192,96
C 0,96,192

11111111111111111111
1W001000100000000011
11101010111011111011
10101010001000101011
10101011101010101011
10100010001010101011
10111110111010101011
10000010100010101011
10101110101110101011
10100010100010101011
10111010111010101011
10001010001010100011
11111011101010111111
10000000101010000011
10111110101111111011
10100000100010000011
10111111111010111011
10000000000000100011
11111111111111111111
11111111111111111111
