NO ./wall_no.xpm
SO ./wall_so.xpm
WE ./wall_we.xpm
EA ./wall_ea.xpm

F 0,192,96
C 0,96,192

1111111111111111111111111111
1000000000000000000000000001
1000000000000000000000000001
1000000000000000000000000001
1000000000000000000000000001
1000000000000000000000000001
1000000000000000000000000001
1000000000000000000000000001
1000000000000000000000000001
1000000000000000000000000001
1000000000000000000000000001
1000000000000000000000000001
1000000000000000000000000001
1000000000000000000000000001
1000000000000000000000000001
10000000000N0000000000000001
1000000000000000000000000001
1111111111111111111111111111
