NO ./wall_no.xpm
SO ./wall_so.xpm
WE ./wall_we.xpm
EA ./wall_ea.xpm

F 0,192,96
C 0,96,192

11111111111111111
10000000000000001
10000000000000001
10000010000000001
10000001010000001
10000000000000001
10000010101000001
10001000000010001
10000010W01000001
10001000000010001
10000010101000001
10000000000000001
10000001010000001
10000000000000001
10000000000000001
10000000000000001
11111111111111111